- - - - - - - - - - - - - - -
| * * * * * * ? * * * * * * |
| $ * * * * * * * * * * * $ |
| - * * - - - - - - - * * - |
| $ * * - - - - - - - * * $ |
| * * * * * * * * * * * * * |
| | | * * * * * * * * * | | |
| | | * * - - - - - * * | | |
| | | * * | * # * | * * | | |
| | | * * | * * * | * * | | |
| * * * * * * * * * * * * * |
| * * * * * * ? * * * * * * |
- - - - - - - - - - - - - - -
