- - - - - - - - - - - - - - -
| # * * * * * * * * * * * * |
| * * * * * * * * * * * * * |
| - - * * - - - - - * * - - |
| $ * * * - - - - - * * * $ |
| * * * * * * * * * * * * * |
| - - * * * * * * * * * - - |
| * * * * | * * * | * * * * |
| * * * * | * * * | * * * * |
| - - * * | * * * | * * - - |
| * * * * | * # * | * * * * |
| $ * * * | - - - | * * * $ |
- - - - - - - - - - - - - - -
