- - - - - - - - - - - - - - -
| * * * * * * * * * * * * $ |
| * $ * * - - - - - - - - - |
| * * * * | * * * * * * * * |
| * * * * | * * * * * * * * |
| * * * * * * * * * * * * * |
| * * * * * * * * * * * * * |
| * * * * * * * * | * * * * |
| * * * * * * * * | * * * * |
| - - - - - - - - - * * $ * |
| $ * * * * * * * * * * * * #
- - - - - - - - - - - - - - -
