- - - - - - - - - - - - - - -
| # * * * * * * * * * * * * |
| * * * * * * * * * * * * * |
| - - * * - - - - - * * - - |
| $ * * * - - - - - * * * $ |
| * * * * * * * * * * * * * |
| - - * * * * * * * * * - - |
| * * * * | * * * | * * * * |
| * * * * | * * * | * * * * |
| - * * * | * * * | * * * - |
| * * * * | * # * | * * * * |
| $ * * * | * * * | * * * $ |
- - - - - - - - - - - - - - -
