- - - - - - - - - - - - - - -
| * * * * * * * * * * * * $ |
| * $ * * * * * * * * * * * |
| * * * - - - - - - - - - - |
| * * * | * * * * * * * * * |
| * * * | * * * * * * * * * |
| * * * * * * * * * | * * * |
| * * * * * * * * * | * * * |
| - - - - - - - - - - * * * |
| * * * * * * * * * * * $ * |
| $ * * * * * * * * * * * * |
| * * * * * * * * * * * * # |
- - - - - - - - - - - - - - -
