- - - - - - - - - - - - - - -
| * * * * * * * * * * * * * |
| $ * * * * * * * * * * * $ |
| - * * - - - - - - - * * - |
| * * * * * * * * * * * * * |
| * * * * * * * * * * * * * |
| | | * * - - - - - * * | | |
| | | * * | * # * | * * | | |
| | | * * | * * * | * * | | |
| | | * * | * * * | * * | | |
| * * * * * * * * * * * * * |
| $ * * * * * * * * * * * $ |
- - - - - - - - - - - - - - -
